12211211211211221
11221222221211112
33311122221222133
33221112212122233
2%%%     %    %%1
1%             %2
!               2
!               1
D       $       1
1               1
1              %2
1%%       %    %1
33332221122113333
21333321112212331
