12211211211211221
11221112     #  3
33333332#233333 3
2  %    $ %   % 1
2               1
1      !!!      2
!               2
!               1
D               1
1               3
3               3
!%    %     %   3
31122221122112223
21121121112212211
