11211211202112112
122022122|2212210
11211211202112112
20222211112222211
11222112121222112
7--71111117-----7
|22|122211|21121|
7--7111211|12212|
12121222217--7--7
22122211212121212
12217-72122121211
1211|121121201222
0212|221212117112
12127271112111220
