33333333302112112
33333333333212210
33333333333112112
33333311112222211
33333333333222112
33331111113333333
33331222113333333
33331112113333333
12121222213333333
22122211212121212
12213332122121211
12113331121201222
02123331212117112
12123331112111220
