11211211232112112
122322122|2212213
11211211232112112
23222211112222211
11222112121222112
7--71111117-----7
|22|122211|21121|
7--7111211|12212|
12121222217--3--7
22122211212121212
12217-72122121211
1211|121121231222
3212|221212113112
12127231112111223
