21111/22217112112
 121/     |221   
 121      |332   
 222    M |332   
 121    9 |332   
 2117   |2|322   
 221|   |2|2223  
 323|   7-7---7  
 333|   #        
c1227---7------7c
                 
                 
     c           
711127-----722117
