21111/22211112112
                 
                 
                 
   71133313327   
  21/        12  
  12         \1  
  22    M     1  
  23    9     #  
 333    |     #  
 133    |    323 
 333    |        
        |        
711112227^^^^^117
