7--7---------7--7
|  |         |  |
|  7         7  |
|               |
|       I       |
7       5       7
|     22222     |
|    1221221    |
|   7-------7   |
7---------------7
|22|222333222|22|
|117121221221721|
|12|121233121|12|
7--7---------7--7
