2   3      333  3
2           w   1
2               1
33      33      1
3               1
2               2
2    3          2
1    3          2
1               3
1               3
1     33    3   2
2           3   2
2               3
3  3      33    3
