44              2
4               4
4   c         444
4   6           4
2  4444         2
2          44   4
2               2
2               2
2       6c      2
2     44444     4
2               4
2           c   4
46          444 4
444             4
