21              1
21 %         1112
2122          \22
222            22
22%            22
22    2222     12
21    %  %     12
2              12
2   %          22
22  22    222  22
22         %   22
22              2
21     %        2
11    2222    112
