11211211211211211
 2122/     332121
 21/        33311
 32          3211
 33     c      22
 33    333     21
 33            33
 #             33
 #           1@13
 #           2213
 222         3322
 1213        3333
 1223 c    S 3333
11211211211122112
