7--7---------7--7
|  |         |  |
|  7         7  |
|               |
|               |
7               7
|               |
|               |
|               |
7----7     7----7
|22|2|  I  |2|22|
|1171|  5  |1721|
|12|1|12231|1|12|
7--7-7111117-7--7
