21111112114111112
   \/        \/  
                 
                 
                 
  2110     7412  
  121|     |121  
  211|     |111  
  211|     |212  
 2114|     |1112 
 1221|     |1221 
 1112|  W  |2111 
 2112|  7  |2112 
111117--7--711114
