11112222112212211
\11/          \1/
                 
                 
                 
         h       
    21112211122  
    31122222113  
  3321/     \13  
  3333       123 
  3333   B   223 
     3   5     # 
3333     7---722 
33333221122133322
