3               3
33           3333
33333           2
2   #           2
2   #      33   3
3   333###333   3
2               2
2      g        2
2      %  %     3
3     22122     3
3        %      2
2        g      2
2               3
3   333    333##3
