2               1
2               1
2  7--7   7--7  2
1               2
1               1
2      7-7      1
1       %       2
1               1
1               1
2         333   1
2  333          1
1               2
1               1
211    7-7    222
