3               3
33             33
323           312
2113         3222
2    33   33    3
3               3
2               2
2               2
2               3
3   ???333???   3
3               2
2               2
2               3
3  3333   3333  3
