3               3
33             33
3333         3332
2               2
2               3
3   333   333   3
2               2
2               2
2               3
3     33333     3
3               2
2               2
2               3
3  3333   3333  3
