21111/22211112112
\1/12221112122/  
   #         #   
   #         #   
   #         #   
  1117     7111  
  121/     \121  
  122       221  
  221       112  
 112         211 
 212    C    212 
 111   7-7   111 
                 
01111881018810110
